d  mmmmm m  mmm
 m     m mm m  
  mm m   m    m
m   mmmm   mmmm
   m     mmm  m
mm mmmm mm   mm
   mmm    mm mm
 m   mm m mm  m
 mm m   m    mm
mmm  mmmm mmmmm
mmm mm m  mm  m
m      m mm  mm
  mm  m     mmm
mmmmm mm mm mmm
m    mmm  m   a
