d  m  mm    mmm
 m     m mm m  
  mm m   mm   m
m   mmm    mmmm
     m   mmm  m
mm mmm  mm   mm
    mm    mm mm
 m   mm m mm  m
 mm m   m    mm
mmm  mmmm m  mm
m m mm m  mm  m
m      m mm  mm
  mm  m     mmm
  mm  mm mm mmm
m    mmm  m   a
